NO ./ path_to_th e _ n o r t h _texture




SO ./path_to_the_south_texture

WE ./path_to_the_west_texture
E A    ./path_to_the_ea s t _ t e x t ur e      

F 0,0,25 
C 112,101,23

                     1111
                     1111
        1111111111111111111111111
        10000000001100000111000011
        101100000111000001 1000001
        10010000000000000111000000
1111111110110000011100000000000011
100000000011000001110111111111111
11110111111111011100000010001
11110111111111011101010010001
11000000110101011100000010001
10000000000000001100000010001
10000000000000001101010010001
11000001110101011111011110E0111
11110111 1110101 101111010001
11111111 1111111 111111111111
1110011
1111111