
NO ./texture/bluestone.xpm
WE  . /text ure/eagle.xpm

SO ./text    ur e/ gr e ysto    ne.     xpm

EA ./texture/redbrick.xp m

F 128,128, 128
C 0, 0, 0

111111111111111
100000100000001
100000000000001
100000000000001
10000000N000001
100000000000001
100000000000001
100000000000001
100000000000001
100000100000001
100000010000001
100000000000001
100000000000001
100000000000001
100000000000001
100000000000001
111111111111111
