
NO ./texture/bluestone.xpm
S O  . /text ure/eagle.xpm

WE ./text    ur e/ gr e ysto    ne.     xpm

EA ./texture/redbrick.xp m

F 128,128, 128
C 0, 0, 0

111111111111111
1E0000000000001
100100000000001
100000000000001
100000000000001
100000000000001
100000S00000001
100000000000001
100000000000001
100000000000001
100000000000001
111111111111111
