NO ./path_to_th e _ n o r t h _texture
SO ./path_to_the_south_texture
WE ./path_to_the_west_texture
EA       ./path_to_t he_ ea     s  t _ t e     x t ur e      

F 220,200,0
C 112, 101, 232

11111
10001
10001
100011E
11111