NO ./path_to_th e _ n o r t h _texture
SO ./path_to_the_south_texture
WE ./path_to_the_west_texture
EA ./path_to_the_ea s t _ t e x t ur e      

F 220,200,0
C 112, 101, 232

111111111111111
101000000000001
100000000000001
100000000000001
100000000000001
100000000000001
100000000000001
100000000000001
100000000000001
100000000000001
111111111111111