NO ./path_to_th e _ n o r t h _texture
SO ./path_to_the_south_texture
WE ./path_to_the_west_texture
EA ./path_to_the_ea s t _ t e x t ur e      

F 220,200,0
C 112, 101, 232

        1111111111111111111111111
 1      10000000001100000111000011
        101100000111000001 10000011
        100100000000000001110000001111
     11111111101100000111000000000000111
 1   100000000011000001110111111111111
 1   11110111111111011100000010001
 1   11110111111111011101010010001
 1   11000000110101011100000010001
 1   10000000000000001100000010001
 1   10000000000000001101010010001
 1   11000001110101011111011110E0111
 1   11110111 1110101 101111010001
1111111111111 1111111 1111111111111111111111111