NO ./path_to_the_north_texture
SO ./path_to_the_south_texture
WE ./path_to_the_west_texture
EA ./path_to_the_east_texture      

F 220,200,0
C 112, 101, 232

1111111111111111
1010000000000011
1000000000000011
1000000000000011
100000E000000011
1000000000000011
1000000000000011
1000000000000011
1000000000000011
1000000000000011
1111111111111111
