


NO ./textures/bluestone.xpm
WE  . /text ures/eagle.xpm
SO ./textures/eagle.xpm


D_C ./textures/bluestone.xpm
EA ./textures/redbrick.xp m

C 0, 0, 0

F 128,128, 128


111111111111111
100000100000001
10000000D000001
10000000W000001
100000000000001
100000000000001
100000000000001
100000000000001
100000000000001
100001010000001
100001010100001
100000000000001
100000000000001
100000000000001
100000000000001
100000000000001
111111111111111