NO ./textures/eagle.xpm
WE ./textures/eagle.xpm
SO ./textures/eagle.xpm
EA ./textures/eagle.xpm

F 58,28,28
C 40,10,255

11111111111111
1111111111
111111110111111111111111111111           11111111
11111111110000111110000111               11111N111
11111  110000111 1111111 111 1111111111111111111111111111
1111111100000001           1111111111    1100111
11111111111111111111                     1101111
1                                        11101
1                                        111111