NO ./textures/bluestone.xpm
WE  . /text ures/eagle.xpm

SO ./text    ur es/greystone.     xpm
EA ./textures/redbrick.xp m

F 128,128,128 
C 0,153,153


11111
10001
10N01
11111



