
NO ./textures/bluestone.xpm
WE  . /text ures/eagle.xpm

SO ./text    ur es/greystone.     xpm
D_O ./textures/pillar.xpm
D_C ./textures/gun3.xpm
EA ./textures/redbrick.xp m

F 128,128, 128
C 0, 0, 0


1111
1001
10N1
1111