
NO ./textures/bluestone.xpm
WE  . /text ures/eagle.xpm

SO ./text    ur es/greystone.     xpm
D_O ./textures/pillar.xpm
D_C ./textures/gun3.xpm
EA ./textures/redbrick.xp m

F 128,128, 128
C 0, 0, 0

111111111111111
100000100000001
100000000000001
100000000000001
100000000000001
100000000000001
100000000000001
100000000000001
100000000000001
1000O0D00000001
100000000000001
100000N00000001
100000000000001
100000000000001
100000000000001
100000000000001
111111111111111