
NO ./textures/bluestone.xpm
WE  . /text ures/eagle.xpm

SO ./text    ur es/greystone.     xpm
D_O ./textures/colorstone.xpm
D_C ./textures/purplestone.xpm
EA ./textures/redbrick.xp m

F 128,128, 128
C 0, 0, 0

111111111111111
100000100000001
100000000000001
100000000000001
100000000000001
100000000000001
100000000000001
100000000000001
100000000000001
100001110000001
100001010100001
100000N00000001
100000000000001
100000000000001
100000000000001
100000000000001
111111111111111
