NO ./textures/bluestone.xpm
WE ./textures/eagle.xpm
SO ./textures/greystone.xpm
EA ./textures/redbrick.xpm

F 128,128,128
C 0,0,0

111111111111111
100000100000001
100000000000001
100000000000001
100000000000001
100000000000001
100000000000001
100000000000001
100000000000001
100001010000001
100001010100001
100000N00000001
100000000000001
100000000000001
100000000000001
100000000000001
111111111111111
